[8,12]
(0,7)
(7,7) | (10,2)
(1,0,1,4)
(1,5,4,1)
(1,7,1,1)
(4,1,1,4)
(5,2,1,2)
(6,6,1,2)
(7,1,3,1)
(9,2,1,2)
(7,4,3,1)
(10,6,1,2)